10
5
# # # # # # # # # #
# # # # # # # # - #
# # # # # # # # # #
# + . . . . . . . #
# # # # # # # # # #